1.516999999999999993e+01 1.563000000000000078e+01 1.592999999999999972e+01 1.513000000000000078e+01
1.565000000000000036e+01 1.584999999999999964e+01 1.600000000000000000e+01 1.541000000000000014e+01
1.549000000000000021e+01 1.626999999999999957e+01 1.666000000000000014e+01 1.530000000000000071e+01
1.667000000000000171e+01 1.717000000000000171e+01 1.717000000000000171e+01 1.630000000000000071e+01
1.689999999999999858e+01 1.701999999999999957e+01 1.717000000000000171e+01 1.664000000000000057e+01
