1.418999999999999950e+01 1.409999999999999964e+01 1.451999999999999957e+01 1.406000000000000050e+01
1.426999999999999957e+01 1.426999999999999957e+01 1.451999999999999957e+01 1.422000000000000064e+01
1.350000000000000000e+01 1.285999999999999943e+01 1.364000000000000057e+01 1.283999999999999986e+01
1.258999999999999986e+01 1.300999999999999979e+01 1.306000000000000050e+01 1.247000000000000064e+01
1.325000000000000000e+01 1.313000000000000078e+01 1.330000000000000071e+01 1.309999999999999964e+01
