1.569999999999999929e+01 1.555000000000000071e+01 1.586999999999999922e+01 1.551999999999999957e+01
1.550000000000000000e+01 1.511999999999999922e+01 1.577999999999999936e+01 1.502999999999999936e+01
1.480000000000000071e+01 1.433999999999999986e+01 1.482000000000000028e+01 1.410999999999999943e+01
1.441999999999999993e+01 1.447000000000000064e+01 1.459999999999999964e+01 1.432000000000000028e+01
1.459999999999999964e+01 1.463000000000000078e+01 1.466999999999999993e+01 1.450999999999999979e+01
