1.334999999999999964e+01 1.321000000000000085e+01 1.358000000000000007e+01 1.316000000000000014e+01
1.324000000000000021e+01 1.408000000000000007e+01 1.427999999999999936e+01 1.324000000000000021e+01
1.369999999999999929e+01 1.315000000000000036e+01 1.383000000000000007e+01 1.291000000000000014e+01
1.299000000000000021e+01 1.352999999999999936e+01 1.358000000000000007e+01 1.271000000000000085e+01
1.372000000000000064e+01 1.378999999999999915e+01 1.385999999999999943e+01 1.357000000000000028e+01
