1.068999999999999950e+01 1.085999999999999943e+01 1.100000000000000000e+01 1.068999999999999950e+01
1.078999999999999915e+01 1.078999999999999915e+01 1.093999999999999950e+01 1.075000000000000000e+01
1.050000000000000000e+01 1.051999999999999957e+01 1.075999999999999979e+01 1.019999999999999929e+01
1.049000000000000021e+01 1.133999999999999986e+01 1.135999999999999943e+01 1.041999999999999993e+01
1.124000000000000021e+01 1.130000000000000071e+01 1.144999999999999929e+01 1.119999999999999929e+01
