1.468999999999999950e+01 1.451999999999999957e+01 1.477999999999999936e+01 1.448000000000000043e+01
1.444999999999999929e+01 1.418999999999999950e+01 1.458000000000000007e+01 1.409999999999999964e+01
1.380000000000000071e+01 1.378999999999999915e+01 1.403999999999999915e+01 1.350999999999999979e+01
1.374000000000000021e+01 1.406000000000000050e+01 1.418999999999999950e+01 1.350000000000000000e+01
1.407000000000000028e+01 1.425000000000000000e+01 1.432000000000000028e+01 1.400000000000000000e+01
