1.169999999999999929e+01 1.152999999999999936e+01 1.185999999999999943e+01 1.139000000000000057e+01
1.143999999999999950e+01 1.123000000000000043e+01 1.165000000000000036e+01 1.119999999999999929e+01
1.089000000000000057e+01 1.072000000000000064e+01 1.115000000000000036e+01 1.061999999999999922e+01
1.065000000000000036e+01 1.105000000000000071e+01 1.111999999999999922e+01 1.050999999999999979e+01
1.110999999999999943e+01 1.111999999999999922e+01 1.139000000000000057e+01 1.105000000000000071e+01
