1.408999999999999986e+01 1.359999999999999964e+01 1.419999999999999929e+01 1.355000000000000071e+01
1.361999999999999922e+01 1.366000000000000014e+01 1.384999999999999964e+01 1.350999999999999979e+01
1.323000000000000043e+01 1.328999999999999915e+01 1.385999999999999943e+01 1.285999999999999943e+01
1.303999999999999915e+01 1.461999999999999922e+01 1.461999999999999922e+01 1.290000000000000036e+01
1.494999999999999929e+01 1.500000000000000000e+01 1.517999999999999972e+01 1.473000000000000043e+01
