1.907999999999999829e+01 1.900000000000000000e+01 1.948000000000000043e+01 1.883999999999999986e+01
1.901999999999999957e+01 1.889000000000000057e+01 1.901999999999999957e+01 1.864999999999999858e+01
1.760000000000000142e+01 1.700000000000000000e+01 1.787000000000000099e+01 1.700000000000000000e+01
1.719000000000000128e+01 1.794999999999999929e+01 1.826000000000000156e+01 1.719000000000000128e+01
1.830000000000000071e+01 1.875000000000000000e+01 1.892999999999999972e+01 1.830000000000000071e+01
