1.723999999999999844e+01 1.714999999999999858e+01 1.785999999999999943e+01 1.705999999999999872e+01
1.741000000000000014e+01 1.767999999999999972e+01 1.816000000000000014e+01 1.730999999999999872e+01
1.689000000000000057e+01 1.691000000000000014e+01 1.737999999999999901e+01 1.646000000000000085e+01
1.687999999999999901e+01 1.792000000000000171e+01 1.807000000000000028e+01 1.651000000000000156e+01
1.803000000000000114e+01 1.814000000000000057e+01 1.835000000000000142e+01 1.782999999999999829e+01
