1.431000000000000050e+01 1.408999999999999986e+01 1.455000000000000071e+01 1.407000000000000028e+01
1.416000000000000014e+01 1.394999999999999929e+01 1.432000000000000028e+01 1.394999999999999929e+01
1.374000000000000021e+01 1.309999999999999964e+01 1.374000000000000021e+01 1.268999999999999950e+01
1.250000000000000000e+01 1.333000000000000007e+01 1.338000000000000078e+01 1.250000000000000000e+01
1.344999999999999929e+01 1.361999999999999922e+01 1.365000000000000036e+01 1.339000000000000057e+01
