1.725000000000000000e+01 1.676999999999999957e+01 1.767000000000000171e+01 1.673000000000000043e+01
1.694000000000000128e+01 1.655999999999999872e+01 1.703000000000000114e+01 1.644999999999999929e+01
1.555000000000000071e+01 1.550999999999999979e+01 1.603999999999999915e+01 1.506000000000000050e+01
1.509999999999999964e+01 1.598000000000000043e+01 1.614999999999999858e+01 1.505000000000000071e+01
1.630000000000000071e+01 1.577999999999999936e+01 1.633999999999999986e+01 1.576999999999999957e+01
