1.723000000000000043e+01 1.689999999999999858e+01 1.739999999999999858e+01 1.680999999999999872e+01
1.680000000000000071e+01 1.648999999999999844e+01 1.719999999999999929e+01 1.642999999999999972e+01
1.580000000000000071e+01 1.551999999999999957e+01 1.635000000000000142e+01 1.514000000000000057e+01
1.511999999999999922e+01 1.569999999999999929e+01 1.603999999999999915e+01 1.511999999999999922e+01
1.603000000000000114e+01 1.621999999999999886e+01 1.628999999999999915e+01 1.603000000000000114e+01
