1.714000000000000057e+01 1.710999999999999943e+01 1.751999999999999957e+01 1.703000000000000114e+01
1.705999999999999872e+01 1.710999999999999943e+01 1.730000000000000071e+01 1.700000000000000000e+01
1.667000000000000171e+01 1.701000000000000156e+01 1.710999999999999943e+01 1.639999999999999858e+01
1.667999999999999972e+01 1.683999999999999986e+01 1.689000000000000057e+01 1.653999999999999915e+01
1.700000000000000000e+01 1.685999999999999943e+01 1.705999999999999872e+01 1.685999999999999943e+01
