1.787000000000000099e+01 1.757000000000000028e+01 1.798999999999999844e+01 1.753999999999999915e+01
1.750000000000000000e+01 1.782000000000000028e+01 1.787000000000000099e+01 1.750000000000000000e+01
1.789999999999999858e+01 1.828999999999999915e+01 1.837000000000000099e+01 1.769999999999999929e+01
1.835000000000000142e+01 1.810999999999999943e+01 1.839999999999999858e+01 1.810999999999999943e+01
1.805999999999999872e+01 1.778000000000000114e+01 1.828999999999999915e+01 1.775000000000000000e+01
