1.835000000000000142e+01 1.810999999999999943e+01 1.839999999999999858e+01 1.810999999999999943e+01
1.805999999999999872e+01 1.778000000000000114e+01 1.828999999999999915e+01 1.775000000000000000e+01
1.730999999999999872e+01 1.682000000000000028e+01 1.730999999999999872e+01 1.657999999999999829e+01
1.655000000000000071e+01 1.725000000000000000e+01 1.732000000000000028e+01 1.651000000000000156e+01
1.735000000000000142e+01 1.769000000000000128e+01 1.773999999999999844e+01 1.733999999999999986e+01
